x____xx__x
xxxx__x_xx
___xx____x
x_xxx__xx_
_xx___xx__
xx_xx__x__
x__xxx___x
x_xxx____x
_____x____
__x____xx_
